15
5 2 NNNNNNNNNNNNNNNNEEEENNNNNNNNNNNNNNNNNNN
5 2 NNNNNNNNNNNNNNNEEEEENNNNNNNNNNNNNNNNNNN
5 2 NNNNNNNNNNNNNNEEEEEENNNNNNNNNNNNNNNNNNN
5 2 NNNNNNNNNNNNNEEEEEEENNNNNNNNNNNNNNNNNNN
5 2 NNNNNNNNNNNNNNNNEEEENNNNNNNNNNNNNNNNNNN
5 2 NNNNNNNNNNNNNNNNEEEENNNNNNNNNNNNNNNNNNN
5 2 NNNNNNNNNNNNNNNNEEEENNNNNNNNNNNNNNNNNNN
5 2 NNNNNNNNNNNNNNNNEEEENNNNNNNNNNNNNNNNNNN
5 2 NNNNNNNNNNNNNNNNEEEENNNNNNNNNNNNNNNNNNN
5 2 NNNNNNNNNNNNNNNNEEEENNNNNNNNNNNNNNNNNNN
5 2 NNNNNNNNNNNNNNNNEEEENNNNNNNNNNNNNNNNNNN
5 2 NNNNNNNNNNNNEEEEEEEEEEEENNNNNNNNNNNNNNN
5 2 NNNNNNNNNNEEEEEEEEEEEEEEEENNNNNNNNNNNNN

